NO ./assets/NNN1152.png
SO ./assets/SSS1152.png
WE ./assets/WWW1152.png
EA ./assets/EEE1152.png

F 20,0,0
C 0,0,10

111111111111111111111111111111111111111111111111111111111111111111
100000000000000000000000000000000000000000000000000000000000000001                        
111111111111111111111111111111111111111111111111111111111111111101                         
                                                               101
                                                               101
                                                               101
                                                               101
                                                               101                          11111
111111111111111111111111111111111111111111111111111111111111111101                           1001
100000000000000000110000000000000000000000000000000000000000000001                            1001
100000000011000001110000000000001111111111111111111111111111111001                             1001
100000000001000000000000000000001       100001               1001                               1001
111111111011000001110000000000001      10011001             1001                                 1001
100000000011000001110111111111111    11001  1001           1001                                   1001
11110111111111011 1000000000W1      10001   10011        11001                                     1001
111101111111110111101000000001      1001     10001       1001                                       1001
100000000000000000000010000001     1001       11001     1001                                         1001
1000000000000000010001000100001   1001          1001   1001                                           1001
10000000000000011110001000000101 1001            1001 1001                                             1001
11000001110101001 101010100001001001              1001001                                               1001
11110111 1110101 100000000000000001                10001                                                 1001
11111111 1110111 11111111111111111                  111                                                   1001
           101                                                                                             1001
           101                                                                                              1001
           101                                                                                               1001
           101                                                                                                1001
           101                                                                                                 1001
           101                                                                                                  1001
           1011111111111111111111111111111111111111111111111111111111111111111111111111111111111111111111111111111001
           10000000000000000000000000000000000000000000000000000000000000000000000000000000000000000000000000000000001
           11111111111111111111111111111111111111111111111111111111111111111111111111111111111111111111111111111111111