
EA ./assets/EEE1152.png
NO ./assets/EEE1152.png
SO ./assets/EEE1152.png
WE ./assets/EEE1152.png

F 0,0,10
C 20,0,0

1111111111111111111111111
1000000000110000000000001
1011000001110000000000001
100100000000000000000000111111111
111111101011000001110000000000001          1111
100000000011000001110111111111111         100001
11110111111111011100000010001             100001
1111011111111101110101001000111           100001
1100000011010101110000001000001           100001
1000000000000000110000001000111            1111
10000000000000001101010000001
110000011101110111110111100011111111111111111111
11110111111010110111101N000000000000000000000001
111111111111111111111111111111111111111111111111