NO ./assets/NNN1152.png
SO ./assets/SSS1152.png
WE ./assets/WWW1152.png
EA ./assets/EEE1152.png

F 20,0,0
C 0,0,10

1111111111111111111111111
1000000000110000000000001
1011000001110000000000001
100100000000000000000000111111111
111111111011000001110000000000001
100000000011000001110111111111111
11110111111111011100000010001
11110111111111011101010010001
11000000110101011100000010001
10000000000000E01100000010001
10000000000000001101010000001
1100000111010101111101111000111
1111011111101011011110100011111
111111111111111111111111111