EA ./assets/EEE1152.png
NO ./pics/bluestone.png
SO ./pics/eagle.png
WE ./pics/bluestone.png

F 250,0,10
C 20,0,0

1111111111111111111111111
1000000000110000000000001
1011000001110000000000001
100100000000000000000000111111111
111111101011000001110000000000001         111111
100000000011000001110111111111111         100001
11110111111111011100000010001             100001
1111011111111101110101001000111           100001
1100000011010101110000001000001           100W01
1000000000000000110000001000111           111111
10000000000000001101010000001
110000011101110111110111100011111111111111111111
111101111110101101111010000000000000000000000001
111111111111111111111111111111111111111111111111
