NO ./assets/NNN1152.png
SO ./assets/SSS1152.png
WE ./assets/WWW1152.png
EA ./assets/EEE1152.png

C 20,0,0
F 0,0,10

1111111111111111111111111
1000000000110000000000001
1011000001110000000000001
100100000000000000000000111111111
111111111011000001110000000000001          111
100000000011000001110111111111111         110111
11110111111111011100000010001             100001
111101111111110111010100100011111111111111100001
110000001101010111000000100000000000000000000001
10000000000000E011000000100011111111111111111011
10000000000000001101010000001               1011
110000011101010111110111100011111111111111111001
111101111110101101111010000000000000000000000001
111111111111111111111111111111111111111111111111



