NO ./pics/bluestonea.png
SO ./pics/eagle.png
WE ./pics/bluestone.png
EA ./assets/EEE1152.png

C 20,0,0
C 255,255,255
F 0,0,10

1111111111111111111111111
1000000000110000000000001
1011000001110000000000001
100100000000000000000000111111111
111111101011000001110000000000001         111111
100000000011000001110111111111111         100001
11110111111111011100000010001             100001
111101111111110111010100100011111111111111100001
110000001101010111000000100000000000000000000W01
100000000000000011000000100011111111111111111111
10000000000000001101010000001
110000011101110111110111100011111111111111111111
111101111110101101111010000000000000000000000001
111111111111111111111111111111111111111111111111
