1111111111111111111111111
1000000000110000000000001
1011000001110000000000001
1001000000000000000000001
111111111011000001110000000010001
100000000011000001110111111111111
11110111111111011100000010001    
11110111111111011101010010001     
11000000110101011100000000001     
10000000000000001100000010001     
10000000000000001101010010001     
11000001110101011111011110N0111  
11110111111010110111101001111    
111111111111111111111111111