NO ./assets/NNN1152.png
SO ./assets/SSS1152.png
WE ./assets/WWW1152.png
EA ./assets/EEE1152.png

F 20,10,2
C 0,0,10

11111111111111111111111111
1000000000110000000000001
1011000001110000000000001
100100000000000000000000111111111
111111111011000001110000000010001
100000000011000001110111111111111
11110111111111011100000010001 1
1111011111111101110101001000111
11000000110101011100000000001
10000000000000001100000010001
10000000000000001101010010001
110000011100000001110000N0111
11110111111010110111101001111
    1      1 1  1    1111
