NO ./assets/NNN1152.png
SO ./assets/SSS1152.png
WE ./assets/WWW1152.png
EA ./assets/EEE1152.png

F 20,0,0
C 0,0,10


11111111111111111111111111111111111111111
10000000000000000010000000000000000000111
11111111111111111000000000000000000001111
11111111111111111000000000000000000001111
11111111111111111000000000000000000001111
10000000000011111000000000000000000001111
11111111111011111000000000000000000001111
11111111111011111000000000000000000001111
11111111111011111000000000000000000001111
10000011111011111000000000000000000001111
11111011111011111000000000000000000001111
11111011111011111000000000000000000001111
11111011111011111000000000000000000001111
11111011111011111000000000000000000001111111
11110011111011111000000000000000000001111111
11111011111011111000000000000000000001111111
11111011111011111000000000000000000001111111
11111011111011111000000000000000000001111111
1000000000001111100N000000000000000001111111
1111111111100000000000000000000111111111
11111111111111000000000000000000001111111
11111111111111000000000000000000001111111
10000000000000000000000000000000001111111
10000000000000000000000000000000000111111
11111111100000000000000000000000000000111
11111111111111111111111111111111111111111