NO ./assets/NNN1152.png
SO ./assets/SSS1152.png
WE ./assets/WWW1152.png
EA ./assets/EEE1152.png

F 10,0,0
C 0,0,10

11111
10001
1N111
10011
10111
10001
11011
110001
100001
100001
110111
101
1111

