NO ./assets/NNN1152.png
SO ./assets/SSS1152.png
WE ./assets/WWW1152.png
EA ./assets/EEE1152.png

F 20,0,0
C 0,0,10

111111111111111
100000000000101
100000N00000001
100000000000001
111111111110001
111   1111100011111
111111111110001
100000000000001
100000000000101
100001001100101
111100000000101
100000000000101
111111111111111