NO ./assets/NNN1152.png
SO ./assets/SSS1152.png
WE ./assets/WWW1152.png
EA ./assets/EEE1152.png

F 20,0,0
C 0,0,10

1111111111111111111111111
1000000000110000000000001
10110000011100000000000011111111111
10010000000000000000000011111111111
11111111101100000111000000001000111
10000000001100000111011110011111111
11110111111111011100000010001110001
11110111111111011101010010001110001
11000000110101011100000010001110001
10000000000000001100000010001110001
10000000000000001101010010000000011
11000001110101011111011110N01110001
11110111111010110111101001111110001
11111111111111111111111111111111111